{
	"parallax_mapping": {
		"enabled": true,
		"min_layers": 4.0,
		"max_layers": 32.0,
		"height_scale": 0.04,
		"lod_cutoff": 1.5
	},

	"shadow_mapping": {
		"sample_radius": 1,
		"esm_exponent": 35,
		"esm_exponent_layer_scale_factor": 1.8,
		"billboard_alpha_threshold": 0.8,
		"inter_cascade_blend_threshold": 0.3,

		"cascades": {
			"num_cascades": 6,
			"num_depth_buffer_bits": 16,
			"resolution": 1024,
			"sub_frustum_scale": 1.2,
			"linear_split_weight": 0.2
		}
	},

	"volumetric_lighting": {
		"num_samples": 50,
		"sample_density": 1.0,
		"opacity": 0.05
	},

	"ambient_occlusion": {
		"tricubic_filtering_enabled": true,
		"strength": 0.9
	},

	"dynamic_light": {
		"time_for_cycle": 2.5,
		"pos": [3.0, 50.0, 36.0],

		"looking_at": {
			"origin": [24.0, 2.5, 20.0],
			"dest": [28.0, 2.5, 17.5]
		}
	},

	"skybox": {
		"texture_path": "../assets/skyboxes/desert.bmp",
		"map_cube_to_sphere": false
	},

	"rgb_light_color": [245, 213, 161],

	"tone_mapping_max_white": 1.0,
	"noise_granularity": 0.001,

	"non_lighting_data": {
		"soundtrack_path": "../assets/audio/themes/new/pyramid.wav",

		"sector_face_texture_paths": [
			"../assets/walls/sand.bmp",
			"../assets/walls/pyramid_bricks_4.bmp",
			"../assets/walls/marble.bmp",
			"../assets/walls/hieroglyph.bmp",
			"../assets/walls/alkadhib.bmp",
			"../assets/walls/saqqara.bmp",
			"../assets/walls/sandstone.bmp",
			"../assets/walls/cobblestone_3.bmp",
			"../assets/walls/rug_3.bmp",
			"../assets/walls/mesa.bmp",
			"../assets/walls/arthouse_bricks.bmp",
			"../assets/walls/eye_of_evil.bmp",
			"../assets/walls/rough_marble.bmp",
			"../assets/walls/mosaic.bmp",
			"../assets/walls/aquamarine_tiles.bmp"
		],

		"heightmap": [
			[3, 3, 3, 3, 3, 3, 3, 3, 3, 5, 5, 5, 5, 5, 5, 5, 5, 5, 5, 5, 5, 5, 5, 5, 5, 5, 5, 5, 5, 5, 5, 5, 5, 5, 5, 5, 5, 5, 5, 5],
			[3, 0, 0, 3, 0, 0, 3, 0, 0, 0, 0, 0, 0, 0, 0, 0, 0, 0, 0, 0, 0, 0, 0, 0, 0, 0, 0, 0, 0, 0, 0, 1, 2, 14,14,14,14,14,14,5],
			[3, 0, 0, 3, 0, 0, 3, 0, 6, 6, 6, 6, 6, 6, 6, 6, 6, 6, 6, 6, 6, 6, 6, 6, 6, 6, 6, 6, 6, 7, 0, 1, 2, 14,15,15,15,15,14,5],
			[3, 0, 0, 0, 0, 0, 3, 0, 6, 8, 1, 1, 1, 1, 1, 1, 1, 1, 1, 1, 1, 1, 1, 1, 1, 1, 1, 1, 6, 7, 0, 1, 2, 14,15,16,16,15,14,5],
			[3, 3, 3, 3, 0, 0, 3, 0, 6, 8, 1, 1, 1, 1, 1, 1, 1, 1, 1, 1, 1, 1, 1, 1, 1, 1, 1, 1, 6, 7, 0, 1, 2, 14,15,16,16,15,14,5],
			[3, 0, 0, 0, 0, 0, 3, 0, 8, 8, 1, 1, 1, 1, 1, 1, 1, 1, 1, 1, 1, 1, 1, 1, 1, 1, 1, 1, 6, 7, 0, 1, 2, 14,15,15,15,15,14,5],
			[5, 0, 0, 0, 0, 0, 5, 0, 8, 8, 1, 1, 1, 1, 1, 1, 1, 1, 1, 1, 1, 15,1, 1, 1, 1, 1, 1, 6, 7, 0, 1, 2, 14,14,14,14,14,14,5],
			[5, 0, 0, 0, 0, 0, 5, 0, 1, 1, 1, 1, 1, 1, 1, 1, 1, 1, 1, 1, 14,1, 1, 1, 1, 1, 1, 1, 6, 7, 0, 1, 2, 2, 2, 2, 2, 2, 2, 5],
			[5, 0, 0, 0, 0, 0, 5, 0, 8, 8, 1, 1, 1, 1, 1, 1, 1, 1, 1, 13,1, 1, 1, 1, 1, 1, 1, 1, 6, 7, 0, 1, 1, 1, 1, 1, 1, 1, 1, 5],
			[5, 1, 1, 1, 1, 5, 5, 0, 8, 8, 1, 1, 1, 1, 1, 1, 1, 1, 12,1, 1, 1, 1, 1, 1, 1, 1, 1, 6, 7, 0, 0, 0, 0, 0, 0, 0, 0, 0, 5],
			[6, 2, 2, 2, 2, 5, 5, 0, 6, 8, 2, 2, 2, 2, 2, 2, 2, 11,2, 2, 2, 2, 15,2, 2, 2, 2, 2, 6, 7, 0, 0, 0, 0, 0, 0, 0, 0, 0, 5],
			[6, 3, 3, 3, 3, 5, 5, 0, 6, 8, 3, 3, 3, 3, 3, 3, 10,3, 3, 3, 3, 14,2, 2, 2, 2, 2, 2, 6, 7, 0, 0, 0, 0, 0, 0, 0, 0, 0, 5],
			[6, 3, 3, 3, 3, 0, 0, 0, 6, 8, 8, 3, 3, 3, 3, 9, 3, 3, 3, 3, 13,3, 2, 2, 2, 2, 2, 2, 6, 7, 1, 1, 1, 0, 0, 0, 0, 0, 0, 5],
			[6, 3, 3, 3, 3, 6, 6, 6, 6, 6, 8, 8, 8, 8, 8, 3, 3, 3, 3, 12,3, 3, 2, 2, 2, 2, 2, 2, 6, 7, 2, 2, 2, 2, 0, 0, 0, 0, 0, 5],
			[6, 3, 3, 3, 3, 3, 3, 3, 3, 3, 3, 3, 3, 3, 3, 3, 3, 3, 11,3, 3, 3, 2, 2, 2, 2, 2, 2, 6, 7, 3, 3, 3, 3, 3, 0, 0, 0, 0, 5],
			[6, 3, 3, 3, 3, 3, 3, 3, 3, 3, 3, 3, 3, 3, 3, 3, 3, 10,3, 3, 3, 3, 2, 2, 2, 2, 2, 2, 6, 7, 4, 4, 4, 4, 4, 4, 4, 4, 4, 5],
			[6, 3, 3, 3, 3, 3, 3, 3, 3, 3, 3, 3, 3, 3, 3, 3, 9, 3, 3, 3, 3, 3, 2, 2, 2, 2, 2, 2, 6, 7, 4, 3, 3, 3, 3, 3, 3, 3, 4, 5],
			[6, 3, 3, 3, 3, 3, 3, 3, 3, 3, 3, 3, 3, 3, 3, 8, 3, 3, 3, 3, 3, 3, 2, 2, 2, 2, 2, 2, 6, 7, 4, 3, 3, 3, 3, 3, 3, 3, 4, 5],
			[6, 6, 6, 6, 6, 6, 6, 6, 6, 6, 8, 8, 8, 8, 8, 3, 3, 3, 3, 3, 3, 3, 2, 2, 2, 2, 2, 2, 6, 7, 4, 3, 3, 3, 3, 3, 3, 3, 4, 5],
			[5, 2, 2, 2, 2, 2, 2, 2, 2, 6, 8, 3, 3, 3, 3, 3, 3, 3, 3, 3, 3, 3, 2, 2, 2, 2, 2, 2, 6, 7, 4, 3, 3, 3, 3, 3, 3, 3, 4, 5],
			[5, 2, 1, 1, 1, 1, 1, 1, 2, 6, 8, 3, 3, 3, 3, 3, 3, 3, 3, 3, 3, 3, 2, 2, 2, 2, 2, 2, 6, 7, 4, 3, 3, 3, 3, 3, 3, 3, 4, 5],
			[5, 2, 1, 0, 0, 0, 0, 1, 2, 6, 8, 3, 3, 3, 3, 3, 3, 3, 3, 3, 3, 3, 2, 2, 2, 2, 2, 2, 6, 7, 4, 3, 3, 3, 3, 3, 3, 3, 4, 5],
			[5, 2, 1, 0, 0, 0, 0, 1, 2, 6, 8, 3, 3, 3, 3, 3, 3, 3, 3, 3, 3, 3, 2, 2, 2, 2, 2, 2, 6, 7, 4, 3, 3, 3, 3, 3, 3, 3, 4, 5],
			[5, 2, 1, 0, 0, 0, 0, 1, 2, 6, 6, 6, 6, 6, 6, 6, 6, 6, 6, 3, 3, 3, 2, 2, 2, 2, 2, 2, 6, 7, 4, 3, 3, 3, 3, 3, 3, 3, 4, 5],
			[5, 2, 1, 0, 1, 1, 1, 1, 2, 0, 0, 0, 3, 3, 2, 2, 0, 0, 0, 0, 0, 0, 2, 2, 2, 2, 2, 2, 6, 7, 4, 3, 3, 3, 3, 3, 3, 3, 4, 5],
			[5, 0, 0, 0, 0, 0, 0, 0, 0, 0, 0, 0, 3, 0, 0, 0, 0, 0, 0, 0, 0, 0, 2, 2, 2, 2, 2, 2, 6, 7, 4, 4, 4, 4, 4, 4, 4, 4, 4, 5],
			[5, 0, 0, 0, 3, 3, 3, 3, 3, 3, 3, 3, 3, 0, 0, 2, 0, 0, 0, 0, 0, 0, 2, 2, 2, 2, 2, 2, 6, 7, 0, 0, 0, 0, 3, 0, 0, 0, 0, 5],
			[5, 0, 0, 0, 3, 1, 1, 1, 1, 1, 1, 0, 0, 0, 0, 0, 0, 0, 0, 0, 0, 0, 2, 2, 2, 2, 2, 2, 6, 7, 0, 0, 0, 0, 3, 0, 0, 0, 0, 5],
			[5, 0, 0, 0, 3, 1, 1, 1, 1, 1, 1, 0, 0, 0, 0, 2, 0, 0, 0, 0, 0, 0, 2, 2, 2, 2, 2, 2, 6, 7, 0, 0, 0, 0, 3, 0, 0, 0, 0, 5],
			[5, 0, 0, 0, 3, 1, 1, 3, 3, 3, 3, 3, 3, 0, 0, 0, 0, 0, 0, 0, 0, 0, 6, 6, 6, 6, 6, 6, 6, 7, 0, 0, 0, 0, 3, 0, 0, 0, 0, 5],
			[5, 0, 0, 0, 3, 1, 1, 3, 3, 3, 3, 3, 3, 0, 0, 2, 0, 2, 0, 2, 0, 2, 2, 2, 2, 2, 2, 2, 2, 7, 0, 0, 0, 0, 2, 0, 0, 0, 0, 5],
			[5, 0, 0, 0, 3, 2, 2, 3, 3, 3, 3, 3, 3, 0, 0, 0, 0, 0, 0, 0, 0, 2, 2, 2, 2, 2, 2, 2, 2, 7, 0, 0, 0, 0, 2, 0, 0, 0, 0, 5],
			[5, 1, 2, 3, 3, 2, 2, 3, 3, 3, 3, 3, 3, 7, 7, 7, 7, 7, 7, 7, 7, 7, 7, 7, 7, 7, 7, 7, 7, 7, 0, 0, 0, 0, 2, 0, 0, 0, 0, 5],
			[5, 1, 2, 3, 3, 2, 2, 3, 3, 3, 3, 3, 3, 7, 7, 7, 7, 7, 7, 7, 7, 7, 7, 2, 2, 2, 1, 1, 1, 1, 1, 1, 1, 1, 1, 1, 1, 1, 1, 5],
			[5, 0, 0, 0, 3, 2, 2, 3, 3, 3, 3, 3, 3, 3, 3, 3, 3, 3, 3, 3, 3, 3, 2, 2, 2, 2, 1, 1, 1, 1, 1, 1, 1, 1, 1, 1, 1, 1, 1, 5],
			[5, 0, 0, 0, 3, 3, 3, 3, 3, 3, 3, 3, 3, 3, 3, 3, 3, 3, 3, 3, 3, 3, 2, 2, 2, 2, 1, 1, 1, 1, 1, 1, 1, 1, 1, 1, 1, 1, 1, 5],
			[5, 0, 0, 0, 3, 3, 3, 3, 3, 3, 3, 3, 3, 3, 3, 3, 3, 3, 3, 3, 3, 3, 2, 2, 2, 2, 1, 1, 1, 1, 1, 1, 1, 1, 1, 1, 1, 1, 1, 5],
			[5, 0, 0, 0, 3, 3, 3, 3, 3, 3, 3, 3, 3, 7, 7, 7, 7, 7, 7, 7, 7, 7, 7, 2, 2, 2, 1, 1, 1, 1, 1, 1, 1, 1, 1, 1, 1, 1, 1, 5],
			[5, 0, 0, 0, 0, 0, 0, 0, 0, 0, 0, 0, 0, 7, 7, 7, 7, 7, 7, 7, 7, 7, 7, 2, 2, 2, 1, 1, 1, 1, 1, 1, 1, 1, 1, 1, 1, 1, 1, 5],
			[5, 5, 5, 5, 5, 5, 5, 5, 5, 5, 5, 5, 5, 5, 5, 5, 5, 5, 5, 5, 5, 5, 5, 5, 5, 5, 5, 5, 5, 5, 5, 5, 5, 5, 5, 5, 5, 5, 5, 5]
		],

		"texture_id_map": [
			[1, 1, 1, 1, 11,11,1, 1, 1, 1, 1, 1, 1, 1, 1, 1, 1, 1, 1, 1, 1, 1, 1, 1, 1, 1, 1, 1, 1, 1, 1, 1, 1, 1, 1, 1, 1, 1, 1, 1],
			[1, 0, 0, 1, 11,11,1, 0, 0, 0, 0, 0, 0, 0, 0, 0, 0, 0, 0, 0, 0, 0, 0, 0, 0, 0, 0, 0, 0, 0, 0, 12,12,12,12,12,12,12,12,1],
			[1, 0, 0, 1, 11,11,1, 0, 3, 3, 3, 3, 3, 3, 3, 3, 3, 3, 3, 3, 3, 3, 3, 3, 3, 3, 3, 3, 3, 10,0, 12,12,12,13,13,13,13,12,1],
			[1, 0, 0, 0, 0, 0, 1, 0, 3, 5, 2, 2, 2, 2, 2, 2, 2, 2, 2, 2, 2, 2, 2, 2, 2, 2, 2, 2, 3, 10,0, 12,12,12,13,14,14,13,12,1],
			[1, 1, 1, 1, 0, 0, 1, 0, 3, 5, 2, 2, 2, 2, 2, 2, 2, 2, 2, 2, 2, 2, 2, 2, 2, 2, 2, 2, 3, 10,0, 12,12,12,13,14,14,13,12,1],
			[1, 0, 0, 0, 0, 0, 1, 0, 5, 5, 2, 2, 2, 2, 2, 2, 2, 2, 2, 2, 2, 2, 2, 2, 2, 2, 2, 2, 3, 10,0, 12,12,12,13,13,13,13,12,1],
			[1, 0, 0, 0, 0, 0, 1, 0, 5, 5, 2, 2, 2, 2, 2, 2, 2, 2, 2, 2, 2, 5, 2, 2, 2, 2, 2, 2, 3, 10,0, 12,12,12,12,12,12,12,12,1],
			[1, 0, 0, 0, 0, 0, 1, 0, 2, 2, 2, 2, 2, 2, 2, 2, 2, 2, 2, 2, 5, 2, 2, 2, 2, 2, 2, 2, 3, 10,0, 12,12,12,12,12,12,12,12,1],
			[1, 0, 0, 0, 0, 0, 1, 0, 5, 5, 2, 2, 2, 2, 2, 2, 2, 2, 2, 5, 2, 2, 2, 2, 2, 2, 2, 2, 3, 10,0, 12,12,12,12,12,12,12,12,1],
			[1, 2, 2, 2, 2, 1, 1, 0, 5, 5, 2, 2, 2, 2, 2, 2, 2, 2, 5, 2, 2, 2, 2, 2, 2, 2, 2, 2, 3, 10,0, 0, 0, 0, 0, 0, 0, 0, 0, 1],
			[3, 2, 2, 2, 2, 1, 1, 0, 3, 5, 2, 2, 2, 2, 2, 2, 2, 5, 2, 2, 2, 2, 5, 2, 2, 2, 2, 2, 3, 10,0, 0, 0, 0, 0, 0, 0, 0, 0, 1],
			[3, 2, 2, 2, 2, 1, 1, 0, 3, 5, 2, 2, 2, 2, 2, 2, 5, 2, 2, 2, 2, 5, 2, 2, 2, 2, 2, 2, 3, 10,0, 0, 0, 0, 0, 0, 0, 0, 0, 1],
			[3, 2, 2, 2, 2, 0, 0, 0, 3, 5, 5, 2, 2, 2, 2, 5, 2, 2, 2, 2, 5, 2, 2, 2, 2, 2, 2, 2, 3, 10,1, 1, 1, 0, 0, 0, 0, 0, 0, 1],
			[3, 2, 2, 2, 2, 3, 3, 3, 3, 3, 5, 5, 5, 5, 5, 2, 2, 2, 2, 5, 2, 2, 2, 2, 2, 2, 2, 2, 3, 10,1, 1, 1, 1, 0, 0, 0, 0, 0, 1],
			[3, 2, 2, 2, 2, 2, 2, 2, 2, 2, 2, 2, 2, 2, 2, 2, 2, 2, 5, 2, 2, 2, 2, 2, 2, 2, 2, 2, 3, 10,1, 1, 1, 1, 1, 0, 0, 0, 0, 1],
			[3, 2, 2, 2, 2, 2, 2, 2, 2, 2, 2, 2, 2, 2, 2, 2, 2, 5, 2, 2, 2, 2, 2, 2, 2, 2, 2, 2, 3, 10,1, 1, 1, 1, 1, 1, 1, 1, 1, 1],
			[3, 2, 2, 2, 2, 2, 2, 2, 2, 2, 2, 2, 2, 2, 2, 2, 5, 2, 2, 2, 2, 2, 2, 2, 2, 2, 2, 2, 3, 10,1, 1, 1, 1, 1, 1, 1, 1, 1, 1],
			[3, 2, 2, 2, 2, 2, 2, 2, 2, 2, 2, 2, 2, 2, 2, 5, 2, 2, 2, 2, 2, 2, 2, 2, 2, 2, 2, 2, 3, 10,1, 1, 1, 1, 1, 1, 1, 1, 1, 1],
			[3, 3, 3, 3, 3, 3, 3, 3, 3, 3, 5, 5, 5, 5, 5, 2, 2, 2, 2, 2, 2, 2, 2, 2, 2, 2, 2, 2, 3, 10,1, 1, 1, 1, 1, 1, 1, 1, 1, 1],
			[1, 9, 9, 9, 9, 9, 9, 9, 9, 3, 5, 2, 2, 2, 2, 2, 2, 2, 2, 2, 2, 2, 2, 2, 2, 2, 2, 2, 3, 10,1, 1, 1, 1, 1, 1, 1, 1, 1, 1],
			[1, 9, 4, 4, 4, 4, 4, 4, 9, 3, 5, 2, 2, 2, 2, 2, 2, 2, 2, 2, 2, 2, 2, 2, 2, 2, 2, 2, 3, 10,1, 1, 1, 1, 1, 1, 1, 1, 1, 1],
			[1, 9, 4, 0, 0, 0, 0, 4, 9, 3, 5, 2, 2, 2, 2, 2, 2, 2, 2, 2, 2, 2, 2, 2, 2, 2, 2, 2, 3, 10,1, 1, 1, 1, 1, 1, 1, 1, 1, 1],
			[1, 9, 4, 0, 0, 0, 0, 4, 9, 3, 5, 2, 2, 2, 2, 2, 2, 2, 2, 2, 2, 2, 2, 2, 2, 2, 2, 2, 3, 10,1, 1, 1, 1, 1, 1, 1, 1, 1, 1],
			[1, 9, 4, 0, 0, 0, 0, 4, 9, 3, 3, 3, 3, 3, 3, 3, 3, 3, 3, 2, 2, 2, 2, 2, 2, 2, 2, 2, 3, 10,1, 1, 1, 1, 1, 1, 1, 1, 1, 1],
			[1, 9, 4, 0, 4, 4, 4, 4, 9, 0, 0, 0, 6, 6, 6, 6, 0, 0, 0, 0, 0, 0, 2, 2, 2, 2, 2, 2, 3, 10,1, 1, 1, 1, 1, 1, 1, 1, 1, 1],
			[1, 0, 0, 0, 0, 0, 0, 0, 0, 0, 0, 0, 6, 0, 0, 0, 0, 0, 0, 0, 0, 0, 2, 2, 2, 2, 2, 2, 3, 10,1, 1, 1, 1, 1, 1, 1, 1, 1, 1],
			[1, 0, 0, 0, 6, 6, 6, 6, 6, 6, 6, 6, 6, 0, 0, 6, 0, 0, 0, 0, 0, 0, 2, 2, 2, 2, 2, 2, 3, 10,0, 0, 0, 0, 14,0, 0, 0, 0, 1],
			[1, 0, 0, 0, 6, 7, 7, 7, 7, 7, 7, 0, 0, 0, 0, 0, 0, 0, 0, 0, 0, 0, 2, 2, 2, 2, 2, 2, 3, 10,0, 0, 0, 0, 14,0, 0, 0, 0, 1],
			[1, 0, 0, 0, 6, 7, 7, 7, 7, 7, 7, 0, 0, 0, 0, 6, 0, 0, 0, 0, 0, 0, 2, 2, 2, 2, 2, 2, 3, 10,0, 0, 0, 0, 14,0, 0, 0, 0, 1],
			[1, 0, 0, 0, 6, 7, 7, 6, 6, 6, 6, 6, 6, 0, 0, 0, 0, 0, 0, 0, 0, 0, 3, 3, 3, 3, 3, 3, 3, 10,0, 0, 0, 0, 14,0, 0, 0, 0, 1],
			[1, 0, 0, 0, 6, 7, 7, 6, 6, 6, 6, 6, 6, 0, 0, 6, 0, 6, 0, 6, 0, 6, 6, 6, 6, 6, 6, 6, 6, 10,0, 0, 0, 0, 14,0, 0, 0, 0, 1],
			[1, 0, 0, 0, 6, 7, 7, 6, 6, 6, 6, 6, 6, 0, 0, 0, 0, 0, 0, 0, 0, 6, 6, 6, 6, 6, 6, 6, 6, 10,0, 0, 0, 0, 14,0, 0, 0, 0, 1],
			[1, 6, 6, 6, 6, 7, 7, 6, 6, 6, 6, 6, 6, 10,10,10,10,10,10,10,10,10,10,10,10,10,10,10,10,10,0, 0, 0, 0, 14,0, 0, 0, 0, 1],
			[1, 6, 6, 6, 6, 7, 7, 6, 6, 6, 6, 6, 6, 10,10,10,10,10,10,10,10,10,10,2, 2, 2, 8, 8, 8, 8, 8, 8, 8, 8, 8, 8, 8, 8, 8, 1],
			[1, 0, 0, 0, 6, 7, 7, 6, 6, 6, 6, 6, 6, 2, 2, 2, 2, 2, 2, 2, 2, 2, 2, 2, 2, 2, 8, 8, 8, 8, 8, 8, 8, 8, 8, 8, 8, 8, 8, 1],
			[1, 0, 0, 0, 6, 6, 6, 6, 6, 6, 6, 6, 6, 2, 2, 2, 2, 2, 2, 2, 2, 2, 2, 2, 2, 2, 8, 8, 8, 8, 8, 8, 8, 8, 8, 8, 8, 8, 8, 1],
			[1, 0, 0, 0, 6, 6, 6, 6, 6, 6, 6, 6, 6, 2, 2, 2, 2, 2, 2, 2, 2, 2, 2, 2, 2, 2, 8, 8, 8, 8, 8, 8, 8, 8, 8, 8, 8, 8, 8, 1],
			[1, 0, 0, 0, 6, 6, 6, 6, 6, 6, 6, 6, 6, 10,10,10,10,10,10,10,10,10,10,2, 2, 2, 8, 8, 8, 8, 8, 8, 8, 8, 8, 8, 8, 8, 8, 1],
			[1, 0, 0, 0, 0, 0, 0, 0, 0, 0, 0, 0, 0, 10,10,10,10,10,10,10,10,10,10,2, 2, 2, 8, 8, 8, 8, 8, 8, 8, 8, 8, 8, 8, 8, 8, 1],
			[1, 1, 1, 1, 1, 1, 1, 1, 1, 1, 1, 1, 1, 1, 1, 1, 1, 1, 1, 1, 1, 1, 1, 1, 1, 1, 1, 1, 1, 1, 1, 1, 1, 1, 1, 1, 1, 1, 1, 1]
		]
	}
}
