{
	"init_pos_x": 1.5,
	"init_pos_y": 0.5,
	"init_pos_z": 1.5,

	"shadow_mapping": {
		"resolution_x": 1024, "resolution_y": 1024, "num_layers": 5,
		"linear_split_weight": 0.1, "z_scale": 20.0,
		"light_angle_hori": 150.0, "light_angle_vert": 5.0
	},

	"normal_mapping": {
		"blur": {"radius": 2, "std_dev": 0.8},
		"intensity": 1.1
	},

	"heightmap": [
		[5, 5, 5, 5, 5, 3, 3, 3, 3, 3, 3, 3, 3, 3, 3, 3, 3, 3, 3, 3, 3, 3, 3, 3, 3],
		[5, 0, 0, 0, 5, 0, 0, 0, 0, 0, 0, 0, 0, 0, 0, 0, 0, 0, 0, 0, 0, 0, 0, 0, 3],
		[5, 0, 0, 0, 5, 0, 0, 0, 0, 2, 0, 2, 0, 2, 0, 0, 0, 0, 0, 0, 0, 2, 2, 0, 3],
		[5, 0, 0, 0, 5, 0, 0, 2, 0, 2, 0, 2, 0, 2, 0, 2, 0, 0, 0, 0, 0, 2, 2, 0, 3],
		[5, 5, 5, 0, 5, 0, 0, 2, 0, 2, 0, 2, 0, 2, 0, 2, 0, 0, 0, 0, 0, 2, 2, 0, 3],
		[3, 0, 0, 0, 5, 0, 0, 0, 0, 0, 0, 0, 0, 0, 0, 0, 0, 3, 2, 1, 0, 0, 0, 0, 3],
		[3, 0, 5, 5, 5, 0, 0, 2, 2, 2, 2, 2, 2, 2, 2, 2, 0, 1, 1, 1, 1, 1, 1, 0, 3],
		[3, 0, 0, 0, 0, 0, 0, 2, 0, 0, 0, 0, 0, 0, 0, 2, 0, 1, 0, 0, 0, 0, 1, 0, 3],
		[3, 0, 0, 1, 0, 3, 0, 2, 0, 1, 0, 0, 0, 1, 0, 2, 0, 1, 0, 0, 1, 0, 1, 0, 3],
		[3, 0, 0, 0, 0, 0, 0, 2, 0, 0, 0, 0, 0, 0, 0, 2, 0, 1, 0, 0, 1, 0, 1, 0, 3],
		[3, 0, 0, 3, 0, 1, 0, 2, 2, 2, 2, 0, 2, 2, 2, 2, 0, 1, 1, 1, 1, 0, 1, 0, 3],
		[3, 0, 0, 0, 0, 0, 0, 0, 0, 0, 2, 0, 2, 0, 0, 0, 0, 0, 0, 0, 0, 0, 1, 0, 3],
		[3, 0, 0, 1, 0, 3, 0, 0, 0, 0, 2, 0, 2, 0, 0, 0, 0, 0, 1, 1, 1, 1, 1, 0, 3],
		[3, 0, 0, 0, 0, 0, 0, 0, 0, 0, 0, 0, 0, 0, 0, 0, 0, 0, 0, 0, 0, 0, 0, 0, 3],
		[3, 3, 3, 3, 3, 3, 3, 3, 3, 3, 3, 3, 3, 3, 3, 3, 3, 3, 3, 3, 3, 3, 3, 3, 3]
	],

	"texture_id_map": [
		[4, 4, 4, 4, 4, 1, 1, 1, 1, 1, 1, 1, 1, 1, 1, 1, 1, 1, 1, 1, 1, 1, 1, 1, 1],
		[4, 0, 0, 0, 4, 0, 0, 0, 0, 0, 0, 0, 0, 0, 0, 0, 0, 0, 0, 0, 0, 0, 0, 0, 1],
		[4, 0, 0, 0, 4, 0, 0, 0, 0, 3, 0, 3, 0, 3, 0, 0, 0, 0, 0, 0, 0, 3, 3, 0, 1],
		[4, 0, 0, 0, 4, 0, 0, 3, 0, 3, 0, 3, 0, 3, 0, 3, 0, 0, 0, 0, 0, 3, 3, 0, 1],
		[4, 4, 4, 0, 4, 0, 0, 3, 0, 3, 0, 3, 0, 3, 0, 3, 0, 0, 0, 0, 0, 3, 3, 0, 1],
		[1, 0, 0, 0, 4, 0, 0, 0, 0, 0, 0, 0, 0, 0, 0, 0, 0, 1, 3, 4, 0, 0, 0, 0, 1],
		[1, 0, 4, 4, 4, 0, 0, 5, 5, 5, 5, 5, 5, 5, 5, 5, 0, 7, 7, 7, 7, 7, 7, 0, 1],
		[1, 0, 0, 0, 0, 0, 0, 5, 0, 0, 0, 0, 0, 0, 0, 5, 0, 7, 0, 0, 0, 0, 7, 0, 1],
		[1, 0, 0, 2, 0, 1, 0, 5, 0, 6, 0, 0, 0, 6, 0, 5, 0, 7, 0, 0, 7, 0, 7, 0, 1],
		[1, 0, 0, 0, 0, 0, 0, 5, 0, 0, 0, 0, 0, 0, 0, 5, 0, 7, 0, 0, 7, 0, 7, 0, 1],
		[1, 0, 0, 1, 0, 2, 0, 5, 5, 5, 5, 0, 5, 5, 5, 5, 0, 7, 7, 7, 7, 0, 7, 0, 1],
		[1, 0, 0, 0, 0, 0, 0, 0, 0, 0, 5, 0, 5, 0, 0, 0, 0, 0, 0, 0, 0, 0, 7, 0, 1],
		[1, 0, 0, 2, 0, 1, 0, 0, 0, 0, 5, 0, 5, 0, 0, 0, 0, 0, 7, 7, 7, 7, 7, 0, 1],
		[1, 0, 0, 0, 0, 0, 0, 0, 0, 0, 0, 0, 0, 0, 0, 0, 0, 0, 0, 0, 0, 0, 0, 0, 1],
		[1, 1, 1, 1, 1, 1, 1, 1, 1, 1, 1, 1, 1, 1, 1, 1, 1, 1, 1, 1, 1, 1, 1, 1, 1]
	],

	"assets_from_disk": {
		"base_asset_path": "../assets/",
		"image_extension": ".bmp",

		"wall_texture_directory": "walls",
		"wall_textures": [
			"sand", "cobblestone_2",
			"cobblestone_3", "stone_2",
			"pyramid_bricks_3", "hieroglyphics",
			"desert_snake", "colorstone"
		]
	}
}
